 __________________________________________________________________________________________________________________________________________
|∽~∽~∽~∽~∽~∽::                                                                                                                             |
|∽~∽~∽~∽~∽~∽~∽::                      ********                                                                                             |
|∽~∽~∽~∽~∽~∽~∽~∽::                  ***********                                                                                            |
|∽~∽~∽~∽~∽~∽~∽::                     **********                                                                                            |
|∽~∽~∽~∽~∽~∽~∽::                      ********                                                     #                                       |
|∽~∽~∽~∽~∽::::                                                                                                                             |
|∽~∽~∽~∽::                                                                                                                                 |
|∽~∽~∽~∽::                                                          **                                                                     |
|∽~∽~∽::                                                           ****                                                                    |
|∽~∽::                                                            ******                                                                   |
|::                                                               ******                                                                   |
|                                                                  *****                                                                   |
|                              #                                    ***                                                                    |
|                                                                                                                                          |
|                                                                                                                                          |
|                                                                                                                                          |
|                                                                                                                                          |
|                                                                                                                                          |
|                                                                                                                                          |
|                                                                                                                                          |
|                                                                                                                                          |
|                        **************                        #                                                                           |
|                        ***************                                                                                                   |
|                         ****#**********                                                                                                  |
|                         ****************                                                                                                 |
|                         *****************                                                                                                |
|                           **********#**                                                                                                  |
|                             **********                                                                                                   |
|                              *******                                                                                                     |
|                                                                                                                                          |
|                                                                                                                                          |
|                                                                                                                                          |
|                                                                                                                                          |
 ‾‾‾‾‾‾‾‾‾‾‾‾‾‾‾‾‾‾‾‾‾‾‾‾‾‾‾‾‾‾‾‾‾‾‾‾‾‾‾‾‾‾‾‾‾‾‾‾‾‾‾‾‾‾‾‾‾‾‾‾‾‾‾‾‾‾‾‾‾‾‾‾‾‾‾‾‾‾‾‾‾‾‾‾‾‾‾‾‾‾‾‾‾‾‾‾‾‾‾‾‾‾‾‾‾‾‾‾‾‾‾‾‾‾‾‾‾‾‾‾‾‾‾‾‾‾‾‾‾‾‾‾‾‾‾‾‾‾