____________________________________________________________________________________________________________________________________________
|∽~∽~∽~∽~∽~∽::                                                                                                                             |
|∽~∽~∽~∽~∽~∽~∽::                      ʷʷʷʷʷʷʷʷ                                                                                             |
|∽~∽~∽~∽~∽~∽~∽~∽::                  ʷʷʷʷʷʷʷʷʷʷʷ                                                                                            |
|∽~∽~∽~∽~∽~∽~∽::                     ʷʷʷʷʷʷʷʷʷʷ                                                                                            |
|∽~∽~∽~∽~∽~∽~∽::                      ʷʷʷʷʷʷʷʷ                                                     җ                                       |
|∽~∽~∽~∽~∽::::                                                                                                                             |
|∽~∽~∽~∽::                                                                                                                                 |
|∽~∽~∽~∽::                                                          ʷʷ                                                                     |
|∽~∽~∽::                                                           ʷʷʷʷ                                                                    |
|∽~∽::                                                            ʷʷʷʷʷʷ                                                                   |
|::                                                               ʷʷʷʷʷʷ                                                                   |
|                                                                  ʷʷʷʷʷ                                                                   |
|                              җ                                    ʷʷʷ                                                                    |
|                                                                                                                                          |
|                                                                                                                                          |
|                                                                                                                                          |
|                                                                                                                                          |
|                                                                                                                                          |
|                                                                                                                                          |
|                                                                                                                                          |
|                                                                                                                                          |
|                        ʷʷʷʷʷʷʷʷʷʷʷʷʷʷ                        җ                                                                           |
|                        ʷʷʷʷʷʷʷʷʷʷʷʷʷʷʷ                                                                                                   |
|                         ʷʷʷʷҗʷʷʷʷʷʷʷʷʷʷ                                                                                                  |
|                         ʷʷʷʷʷʷʷʷʷʷʷʷʷʷʷʷ                                                                                                 |
|                         ʷʷʷʷʷʷʷҗʷʷʷʷʷʷʷʷʷ                                                                                                |
|                           ʷʷʷʷʷʷʷʷʷʷҗʷʷ                                                                                                  |
|                             ʷʷʷʷʷʷʷʷʷʷ                                                                                                   |
|                              ʷʷʷʷʷʷʷ                                                                                                     |
|                                                                                                                                          |
|                                                                                                                                          |
|                                                                                                                                          |
|                                                                                                                                          |
‾‾‾‾‾‾‾‾‾‾‾‾‾‾‾‾‾‾‾‾‾‾‾‾‾‾‾‾‾‾‾‾‾‾‾‾‾‾‾‾‾‾‾‾‾‾‾‾‾‾‾‾‾‾‾‾‾‾‾‾‾‾‾‾‾‾‾‾‾‾‾‾‾‾‾‾‾‾‾‾‾‾‾‾‾‾‾‾‾‾‾‾‾‾‾‾‾‾‾‾‾‾‾‾‾‾‾‾‾‾‾‾‾‾‾‾‾‾‾‾‾‾‾‾‾‾‾‾‾‾‾‾‾‾‾‾‾‾‾‾
