____________________________________________________________________________________________________________________________________________
|∽~∽~∽~∽~∽~∽:::ʷ ʷ ʷ                                                                                                                       |
|∽~∽~∽~∽~∽~∽~∽::: ʷ ʷ                                                                                                                      |
|∽~∽~∽~∽~∽~∽~∽~∽:: ʷ                                                ʷʷ                                                                     |
|∽~∽~∽~∽~∽~∽~∽::: ʷ ʷ                                            ʷ ΫΫΫΫʷ                                                                   |
|∽~∽~∽~∽~∽~∽~∽::ʷ ʷ                                               ΫΫΫΫΫΫ                                                                   |
|∽~∽~∽~∽~∽::::: ʷ                                                 ʷΫΫΫΫ ʷ                                              ʷ                   |
|∽~∽~∽~∽:::ʷ ʷ ʷ                                                     ʷ                                             ʷ  ʷΫΫ                  |
|∽~∽~∽~∽:: ʷ ʷ                                                                                                    ʷΫΫΫΫΫΫΫΫʷ               |
|∽~∽~∽:::ʷ ʷ                                                                                                        ΫΫΫΫΫΫ                 |
|∽~∽::: ʷ ʷ                                                                                                         ʷΫΫʷ  ʷ                |
|::::ʷ ʷ                                                                                                                                   |
|ʷ ʷ ʷ                                                                                                                                     |
| ʷ                                                                                                                                        |
|                                                                                                                                          |
|                                                                                                                                          |
|                            ʷ                                                                                                             |
|                            ΫΫʷ                                                                                                           |
|                          ʷΫΫΫΫ                                                                                                           |
|                            ΫΫΫʷ                                                                                                     ʷ ʷ ʷ|
|                           ʷ ΫΫ                                                                                                 ʷ ʷ ʷ ʷ ʷ |
|                              ʷ                                                                                              ʷ ʷ ʷ :::::::|
|                                                                                                                         ʷ ʷ ʷ:::::::~~~~~|
|                                                                     ʷ  ʷʷ                                              ʷ ʷ::::~~~~~~~~~~~|
|                                                                      ΫΫΫΫΫΫʷ ʷ                                       ʷ ʷ ::~~~~~~~~~~~~~~|
|                                                                   ʷΫΫΫΫΫΫΫΫΫΫΫ                                        ʷ ʷ ::~~~~~~~~~~~~~|
|                                                                    ʷ ΫΫΫΫΫΫΫʷ                                            ʷ ʷ::~~~~~~~~~~~|
|                                                                       ʷΫΫΫΫʷ                                           ʷ ʷ ::~~~~~~~~~~~~|
|                                                                         ʷ   ʷ                                         ʷ ʷ:::~~~~~~~~~~~~~|
|                                                                                                                      ʷ ʷ::~~~~~~~~~~~~~~~|
|                                                                                                                     ʷ ʷ ::~~~~~~~~~~~~~~~|
|                                                                                                                       ʷ ʷ::~~~~~~~~~~~~~~|
|                                                                                                                      ʷ ʷ ::~~~~~~~~~~~~~∽|
|                                                                                                                        ʷ ʷ:::~~~~~~~~~~~~|
‾‾‾‾‾‾‾‾‾‾‾‾‾‾‾‾‾‾‾‾‾‾‾‾‾‾‾‾‾‾‾‾‾‾‾‾‾‾‾‾‾‾‾‾‾‾‾‾‾‾‾‾‾‾‾‾‾‾‾‾‾‾‾‾‾‾‾‾‾‾‾‾‾‾‾‾‾‾‾‾‾‾‾‾‾‾‾‾‾‾‾‾‾‾‾‾‾‾‾‾‾‾‾‾‾‾‾‾‾‾‾‾‾‾‾‾‾‾‾‾‾‾‾‾‾‾‾‾‾‾‾‾‾‾‾‾‾‾‾‾
