____________________________________________________________________________________________________________________________________________
|∽~∽~∽~∽~∽~∽::                                                                                                                             |
|∽~∽~∽~∽~∽~∽~∽::                                                                                                                           |
|∽~∽~∽~∽~∽~∽~∽~∽::                                                                                                                         |
|∽~∽~∽~∽~∽~∽~∽::                                                   ΫΫΫΫ                                                                    |
|∽~∽~∽~∽~∽~∽~∽::                                                  ΫΫΫΫΫΫ                                                                   |
|∽~∽~∽~∽~∽::::                                                     ΫΫΫΫ                                                                    |
|∽~∽~∽~∽::                                                                                                                                 |
|∽~∽~∽~∽::                                                                                                                                 |
|∽~∽~∽::                                                                                                                                   |
|∽~∽::                                                                                                                                     |
|::                                                                                                                                        |
|                                                                                                                                          |
|                                                                                                                                          |
|                                                                                                                                          |
|                                                                                                                                          |
|                                                                                                                                          |
|                            ΫΫ                                                                                                            |
|                           ΫΫΫΫ                                                                                                           |
|                            ΫΫΫ                                     ΫΫΫ                                                                   |
|                             ΫΫ                                   ΫΫΫΫΫΫΫΫΫΫ                                                              |
|                                                                ΫΫΫΫΫΫΫΫΫΫΫΫΫΫ                                                            |
|                                                                   ΫΫΫΫΫΫΫΫΫΫ                                                             |
|                                                                     ΫΫΫΫΫΫΫ                                                              |
|                                                                       ΫΫΫΫ                                                               |
|                                                                                                                                          |
|                                                                                                                                          |
|                                                                                                                                          |
|                                                                                                                                          |
|                                                                                                                                          |
|                                                                                                                                          |
|                                                                                                                                          |
|                                                                                                                                          |
|                                                                                                                                          |
‾‾‾‾‾‾‾‾‾‾‾‾‾‾‾‾‾‾‾‾‾‾‾‾‾‾‾‾‾‾‾‾‾‾‾‾‾‾‾‾‾‾‾‾‾‾‾‾‾‾‾‾‾‾‾‾‾‾‾‾‾‾‾‾‾‾‾‾‾‾‾‾‾‾‾‾‾‾‾‾‾‾‾‾‾‾‾‾‾‾‾‾‾‾‾‾‾‾‾‾‾‾‾‾‾‾‾‾‾‾‾‾‾‾‾‾‾‾‾‾‾‾‾‾‾‾‾‾‾‾‾‾‾‾‾‾‾‾‾‾
