____________________________________________________________________________________________________________________________________________
|∽~∽~∽~∽~∽~∽:::                                                                                                                            |
|∽~∽~∽~∽~∽~∽~∽:::                                                                                                                          |
|∽~∽~∽~∽~∽~∽~∽~∽::                                                                                                                         |
|∽~∽~∽~∽~∽~∽~∽:::                                                  ΫΫΫΫ                                                                    |
|∽~∽~∽~∽~∽~∽~∽::                                                  ΫΫΫΫΫΫ                                                                   |
|∽~∽~∽~∽~∽:::::                                                    ΫΫΫΫ                                                                    |
|∽~∽~∽~∽:::                                                                                                           ΫΫΫ                  |
|∽~∽~∽~∽::                                                                                                         ΫΫΫΫΫΫΫΫ                |
|∽~∽~∽:::                                                                                                           ΫΫΫΫΫΫ                 |
|∽~∽:::                                                                                                              ΫΫ                    |
|::::                                                                                                                                      |
|                                                                                                                                          |
|                                                                                                                                          |
|                                                                                                                                          |
|                                                                                                                                          |
|                                                                                                                                          |
|                            ΫΫ                                                                                                            |
|                           ΫΫΫΫ                                                                                                           |
|                            ΫΫΫ                                                                                                           |
|                             ΫΫ                                                                                                           |
|                                                                                                                                   :::::::|
|                                                                                                                              :::::::~~~~~|
|                                                                                                                           ::::~~~~~~~~~~~|
|                                                                      ΫΫΫΫΫΫ                                              ::~~~~~~~~~~~~~~|
|                                                                    ΫΫΫΫΫΫΫΫΫΫΫ                                            ::~~~~~~~~~~~~~|
|                                                                      ΫΫΫΫΫΫΫ                                                ::~~~~~~~~~~~|
|                                                                        ΫΫΫΫ                                                ::~~~~~~~~~~~~|
|                                                                                                                          :::~~~~~~~~~~~~~|
|                                                                                                                         ::~~~~~~~~~~~~~~~|
|                                                                                                                         ::~~~~~~~~~~~~~~~|
|                                                                                                                          ::~~~~~~~~~~~~~~|
|                                                                                                                          ::~~~~~~~~~~~~~∽|
|                                                                                                                           :::~~~~~~~~~~~~|
‾‾‾‾‾‾‾‾‾‾‾‾‾‾‾‾‾‾‾‾‾‾‾‾‾‾‾‾‾‾‾‾‾‾‾‾‾‾‾‾‾‾‾‾‾‾‾‾‾‾‾‾‾‾‾‾‾‾‾‾‾‾‾‾‾‾‾‾‾‾‾‾‾‾‾‾‾‾‾‾‾‾‾‾‾‾‾‾‾‾‾‾‾‾‾‾‾‾‾‾‾‾‾‾‾‾‾‾‾‾‾‾‾‾‾‾‾‾‾‾‾‾‾‾‾‾‾‾‾‾‾‾‾‾‾‾‾‾‾‾
