________________________________________________________________________________
|∽~∽~∽~∽~∽~∽::                                                                 |
|∽~∽~∽~∽~∽~∽~∽::                      ʷʷʷʷʷʷʷʷ                                 |
|∽~∽~∽~∽~∽~∽~∽~∽::                  ʷʷʷʷʷʷʷʷʷʷʷ                                |
|∽~∽~∽~∽~∽~∽~∽::                     ʷʷʷʷʷʷʷʷʷʷ                                |
|∽~∽~∽~∽~∽~∽~∽::                      ʷʷʷʷʷʷʷʷ                                 |
|∽~∽~∽~∽~∽::::                                                                 |
|∽~∽~∽~∽::                                                                     |
|∽~∽~∽~∽::                                                                     |
|∽~∽~∽::                                                                       |
|∽~∽::                                                                         |
|::                                                                            |
|                                                                              |
|                                                                              |
|                                                                              |
|                                            ΫΫΫΫ                              |
|                                             ΫΫΫ                              |
|                                                                              |
|                                                                              |
|                                                                              |
|                            Ӝ                                                 |
|                                                                              |
|                        ʷʷʷʷʷʷʷʷʷʷʷʷʷʷ                                        |
|                        ʷʷʷʷʷʷʷʷʷʷʷԅʷʷʷ                                       |
|                         ʷʷʷʷԅʷʷʷʷʷʷʷʷʷʷ                                      |
|                         ʷʷʷʷʷʷʷʷʷʷʷʷʷʷʷʷʷʷʷʷʷ                                |
|                         ʷʷʷʷʷʷʷʷʷʷʷӜʷʷʷʷʷ                                    |
|                           ʷʷʷʷʷʷʷʷʷʷʷʷʷ                                      |
|                             ʷʷʷʷʷʷʷʷʷʷ                                       |
|                              ʷʷʷʷʷʷʷ                                         |
|                                                                              |
|                                                                              |
|                                                                              |
|                                                                              |
‾‾‾‾‾‾‾‾‾‾‾‾‾‾‾‾‾‾‾‾‾‾‾‾‾‾‾‾‾‾‾‾‾‾‾‾‾‾‾‾‾‾‾‾‾‾‾‾‾‾‾‾‾‾‾‾‾‾‾‾‾‾‾‾‾‾‾‾‾‾‾‾‾‾‾‾‾‾‾‾
