________________________________________________________________________________
|∽~∽~∽~∽~∽~∽::                                                                 |
|∽~∽~∽~∽~∽~∽~∽::                      ʷʷʷʷʷʷʷʷ                                 |
|∽~∽~∽~∽~∽~∽~∽~∽::                  ʷʷʷʷʷʷʷʷʷʷʷ                                |
|∽~∽~∽~∽~∽~∽~∽::                     ʷʷʷʷʷʷʷʷʷʷ                                |
|∽~∽~∽~∽~∽~∽~∽::                      ʷʷʷʷʷʷʷʷ                                 |
|∽~∽~∽~∽~∽::::                                                                 |
|∽~∽~∽~∽::                                                                     |
|∽~∽~∽~∽::                                                                     |
|∽~∽~∽::                                                                       |
|∽~∽::                                                                         |
|::                                                                            |
|                                                                              |
|                              җ                                               |
|                                                                              |
|                                                                              |
|                                                                              |
|                                                                              |
|                                                                              |
|                                                                              |
|                                                                              |
|                                                                              |
|                        ʷʷʷʷʷʷʷʷʷʷʷʷʷʷ                                        |
|                        ʷʷʷʷʷʷʷʷʷʷʷʷʷʷʷ                                       |
|                         ʷʷʷʷҗʷʷʷԅʷʷʷʷʷʷ                                      |
|                         ʷʷʷʷʷʷʷʷʷʷʷʷԅʷʷʷʷʷʷʷʷ                                |
|                         ʷʷʷʷʷʷʷҗʷʷʷʷʷʷʷʷʷ                                    |
|                           ʷʷʷʷҗʷʷʷʷʷҗʷʷ                                      |
|                             ʷʷʷʷʷʷʷʷʷʷ                                       |
|                              ʷʷʷʷʷʷʷ                                         |
|                                                                              |
|                                                                              |
|                                                                              |
|                                                                              |
‾‾‾‾‾‾‾‾‾‾‾‾‾‾‾‾‾‾‾‾‾‾‾‾‾‾‾‾‾‾‾‾‾‾‾‾‾‾‾‾‾‾‾‾‾‾‾‾‾‾‾‾‾‾‾‾‾‾‾‾‾‾‾‾‾‾‾‾‾‾‾‾‾‾‾‾‾‾‾‾
