____________________________________________________________________________________________________________________________________________
|∽~∽~∽~∽~∽~∽::                                                                                                                             |
|∽~∽~∽~∽~∽~∽~∽::                      ʷʷʷʷʷʷʷʷ                                                                                             |
|∽~∽~∽~∽~∽~∽~∽~∽::                  ʷʷʷʷʷʷʷʷʷʷʷ                                                                                            |
|∽~∽~∽~∽~∽~∽~∽::                     ʷʷʷʷʷʷʷʷʷʷ                                                                                            |
|∽~∽~∽~∽~∽~∽~∽::                      ʷʷʷʷʷʷʷʷ                                                     җ                                       |
|∽~∽~∽~∽~∽::::                                                                                                                             |
|∽~∽~∽~∽::                                                                                                                                 |
|∽~∽~∽~∽::                                                          ʷʷ                                                                     |
|∽~∽~∽::                                                           ʷʷʷʷ                                                                    |
|∽~∽::                                                            ʷʷʷʷʷʷ                                                                   |
|::                                                               ʷʷʷʷʷʷ                                                                   |
|                                                                  ʷʷʷʷʷ                                                                   |
|                              җ                                    ʷʷʷ                                                                    |
|                                                                                                                                          |
|                                                                                                                                          |
|                                                                                                                                          |
|                                                                                                                                          |
|                                                                                                                                          |
|                                                                                                                                          |
|                                                                                                                                          |
|                                                                                                                                          |
|                        ʷʷʷʷʷʷʷʷʷʷʷʷʷʷ                        җ                                                                           |
|                        ʷʷʷʷʷʷʷʷʷʷʷʷʷʷʷ                                                                                          ʷʷʷʷʷʷʷʷʷ|
|                         ʷʷʷʷҗʷʷʷԅʷʷʷʷʷʷ                                                                                       ʷʷʷʷʷʷʷʷʷʷʷ|
|                         ʷʷʷʷʷʷԅʷʷʷԅʷԅʷʷʷʷԅʷʷʷ                                                                             ʷʷʷʷʷʷ::::::ʷʷʷ|
|                         ʷʷʷʷʷʷʷҗʷʷʷʷʷʷʷʷʷ                                                                                ʷʷʷʷʷ::∽~∽~∽~:::|
|                           ʷҗҗҗҗʷʷʷʷʷҗʷʷ                                                                                ʷʷʷ::∽~∽~∽~∽~∽~∽~∽|
|                             ʷʷʷʷʷʷʷʷʷʷ                                                                                ʷʷʷʷ::∽~∽~∽~∽~∽~∽~∽|
|                              ʷʷʷʷʷʷʷ                                                                                  ʷʷʷʷ::∽~∽~∽~∽~∽~∽~∽|
|                                                                                                                       ʷʷ::∽~∽~∽~∽~∽~∽~∽~∽|
|                                                                                                                        ʷʷʷ::∽~∽~∽~∽~∽~∽~∽|
|                                                                                                                       ʷʷʷʷ::∽~∽~∽~∽~∽~∽~∽|
|                                                                                                                        ʷʷʷʷʷ::∽~∽~∽~∽~∽~∽|
‾‾‾‾‾‾‾‾‾‾‾‾‾‾‾‾‾‾‾‾‾‾‾‾‾‾‾‾‾‾‾‾‾‾‾‾‾‾‾‾‾‾‾‾‾‾‾‾‾‾‾‾‾‾‾‾‾‾‾‾‾‾‾‾‾‾‾‾‾‾‾‾‾‾‾‾‾‾‾‾‾‾‾‾‾‾‾‾‾‾‾‾‾‾‾‾‾‾‾‾‾‾‾‾‾‾‾‾‾‾‾‾‾‾‾‾‾‾‾‾‾‾‾‾‾‾‾‾‾‾‾‾‾‾‾‾‾‾‾‾
